0
0
000000000000000000000000000000000000000000000000000
011111111111111111111111111111111111111111111111111
011111111111111111111111111111111111111111111111111
011000000000000000000000000000000000000000000000011
011000000000000000000000000000000000000000000000011
011000000000000000000000000000000000000000000000011
011000000000000000000000000000000000000000000000011
011000000000000000000000000000000000000000000000011
011000000000000000000000000000000000000000200000011
011000000000000004444444444444444000000000000000011
011000000000000001111111111111111000000111111110011
011000000000000000000000000000000000000000000000011
011000000000000000000000000000000000000000000000011
011000000000000000000000000000000000000000000000011
011000000000000000000000000000000000000000000000011
011111111111111111111110000000000000000000000000011
011000000000000000000000000000000000000000000000011
011000000090000000000000000000000000000000000000011
011000000000000000000000000001111111111111111111111
011000000000000000000000000000000000000000000000011
011000000000000000000000000000000000000000000000011
011111111111111111111110000000000000000000000000011
011000000000000000000000000000000000000000000000011
011000000000000000000000000000000000000000000000011
011000000000000000000000000001111111111111111111111
011000000000000000000000000000000000000000000000011
011000000000000000000000030000000000000000000000011
011111111111111111111111111111111111111111111111111
011111111111111111111111111111111111111111111111111