1
0
0
00000000000000000000000000000000000
00000000000000000000000000000000000
00000000000011111111111111111111111
00000000000011111111111111111111111
00000000000011555555555555555555511
00000000000011000000000000000000011
00000000000011000000000000000002011
00000000000011000000000000000000011
00000000000011000001111111111111111
00000000000011000000000000000000011
00000000000011000000000000000000011
00000000000011000000000000000000011
00000000000011111110000011111111111
00000000000011000000000000011111111
00000000000011000000000000000011111
00000000000011444444444000000000011
00000000000011111111111110000000011
00000000000011000000000000000000011
00000000000011000000000000001111111
00000000000011000000000300000000011
00000000000011111111111111111111111
00000000000011111111111111111111111