1
1
0
0
0
000000000000000000000000000000000000000000000000000
011111111111111111111111111111111111111111111111111
011111111111111111111111111111111111111111111111111
011000000000000000000000000000000000000000000000011
011000000000000000000000900000000000000000000000011
011000000000000000000000000000000000000000000000011
011666666000001111100000111111111111111100000111111
011000000000001000000000000000001000000100000000011
011000000000001000000000000000001000000100000000011
011000000000001444444440000000001000000111110000011
011000000666661111111111100000001000000000000000011
011000000000001000000000000000001000000000000000011
011000000000001020000000000000001000000000000000011
01100000000000100000000000000BBB1000000000001111111
011666600000001111111111111111111000000000000000011
011000000000000000000001000000000000000000000000011
011000000000000000000001000000000000000000000000011
011000000000000000000001000004444400000111111111111
011000066666600000000000000001111100000000000000011
011000000000000000000000000001111100000000000000011
011000000000000000000000000001111100000000000000011
011000000000000000000000000001111100000000000000011
0111111111111111111111110000000b0000000111111000011
0110000000000000000000000000000000000000000A1000011
0110000000000000000000000000000000000000000A1000011
0110000000000000000000000000000000000000000A1000011
011111110000000111111111111111111111111111111000011
011000000000000000000000000000000000000000000000011
011000000000000030000000000000000000000000000000011
011000000000000000000000000000000000000000000000011
011000011111111111111111111111111111100000000000011
011000000000000000000000000000000091100000000000011
0110000000000000000000000000000000011BBB00000000011
011111111111111111111111111111111111111111111111111
011111111111111111111111111111111111111111111111111