0
0
0
1
000000000000000000000000000000000000000000000000000
011111111111111111111111111111111111111111111111111
011111111111111111111111111111111111111111111111111
011000000000000000000000000000000000000000000000011
011000000000000000000000000000000000000000000000011
011000000000000000000000000000000000200000000000011
011000000000000000000000000000000000000000000000011
011000000000000000000000000000000006660000000000011
01100000000000000000000000000000000CCC0000000000011
011000000000000000000000000000000000000000000000011
011000000000066666666666666666666666666000000000011
011000000000000000000000000000000000000000000000011
011000000000000000000000000000000000000000000000011
011000000000000000000000000000000000000000000000011
011D00000000000000000000000000000000000000000000011
011666666666666666660000000000000000000000000000011
011000000000000000000000000000000000000000000000011
011000000000000000000000000000000000000000000000011
011000000000000000000000000066666666666666666000011
011000000000000000000000000000000000000000000000011
011000000000000000000000000000000000000000000000011
011000666666666666666660000000000000000000000000011
011000000000000000000000000000000000000000000000011
011000000000000000000000000000000000000000000000011
011000000000000000000000000000000000000000000000011
01100000000000000000000000A666666666000000000000011
01100030000000000000000000A666666666444444444444411
011111111111111666666666666666666666111111111111111
011111111111111111111111111111111111111111111111111