1
1
0
1111111111111111111111111111111111111111111111111
1111110000000000000666666600000000000000000000011
1111100000000000000066666004444444440000000000011
1111000000100000000000000001111111110000000000011
1110000000100000000000000000000000010000000000011
1100000000100000000000000000000002010000000000011
1100000000100000000000000000000000010000000BBBB11
1100000000100000000000000111111111110000000111111
1100000000100000000000000000000000000000000000011
1100000000144444444444444444444444444444444444411
1100000000111111111111111111111111111111111111111
1100000000000000110000000000000000000000000000011
1100000000000000110000000000000000000000000000011
110000001110000000000000000000000000BBBBBBB000011
1100000000100000000000666666600000001111111000011
1100000000100000000000666666600000001111111000011
1144444000100000000000555555500000000000000000011
1111111000000000000000000000000000000000000009011
1100001000000000000000000000000000000000000000011
1100001000000000000000000000066666660000000111111
1100001000000000000000000000066666664444444111111
1100000000011111111111111111111111111111111111111
1100000000000000000000000000000000000000000000011
1100000000000000000000000000000000000000000000011
1100000000000000000000000000000000000000000000011
1100000000011111000000000000000000000000000000011
1100000000A11111000000000000000000000000000000011
1100000000A11111000666660000000000000000000300A11
1100000000A11111000111110000000000000000000111111
1100000000A11111444111114444444444444444444444411
1111111111111111111111111111111111111111111111111
1111111111111111111111111111111111111111111111111
