1111111111111111111111111111111111111111111111111
1100000000000000000000000000000100000000000000011
1100000000000000000000000000000100000020000000011
1100000000000000000000000000000100004444444444411
1100000000000000000000000000000110001111111111111
1100000000000000000010000000100000000000000000011
1100000000000000000010000000100000000000000000011
1100000000000000000010000000100000000000000000011
1100000000010000000010000000100000000000000000011
1100000000010000000010000000100000000000000000011
1100000000010000000010000000100000000000000000011
1100000000010000000000000000000000000000000000011
1100000000010000000000000000000000000000000000011
1100000000010000000000000000000000000000000000011
1100000000010000100000001000000000000000000000011
1100000000010000100000001000000000000000000000011
1100000000010000100000001000000000000000000000011
1100000000010000100000001000000000000000000000011
1100000000010000100000001000000000000000000000011
1144444440000000100000001000000000000000000000011
1111111110000000000000000000000000000000000000011
1111111100000000000000000000000000000000000000011
1111111000000000000000000000000000000000000000011
1111110000000000000000000000000000001111111000011
1111100000000000000000000000000000000000000000011
1111000000000000000000000000044444444444444444411
1110000000000000000000000000011111111111111111111
1100000000000000000000000000000000000000000000011
1100000000000000000000000000000000000000000000011
1100000000000000000000000000000000000000444444411
1111111111111111111100000000000000000000111111111
1100000000000000000000000000000000000000000000011
1100000000000000000000000000000000000000000000011
1100000000000000000000000000000000000000000000011
1100000000000000000000000000011111111111111111111
1100000000000000000000000000000000000000000000011
1100000000000000000000000000000000000000000000011
1100000000044444444444444444444000000000000000011
1100000000011111111111111111111000000000000000011
1100000000000000000000000000000000000000000000011
1100000000000000000000000000000000000000000000011
1100000000000000000000000000000000000000000000011
1100000000000000000000000000011111111555111111111
1100000000000000000000003000000000000000000000011
1144444444444444444444444444444444444444444444411
1111111111111111111111111111111111111111111111111
1111111111111111111111111111111111111111111111111