1
1
0
1111111111111111111111111111111111111111111111111111111
1111111111111111111111111111111111111111111111111111111
1100000000000000000000000000000000000000000000CCC000011
1100000000000000000000000000000000000000000000000000011
1100000000000000000000000000000000000000000000000000011
1100000000000000000000000000000000000000000000000000011
1100000100000000000000000000000000000000000000000000011
1100000100000000000000000000000000000000000000111000011
1100000100000000000000000000000000000000000000000000011
1100000100000000000000000000000000000000000000020000011
1100000100444444440004444444440004444444000000000000011
1100000111111111111111111111111111111111111111111111111
1100000055555555555555555555555555550A11000000000000011
1100000000000000000000000000000000000A11000000000000011
1100000000000000000000000000000000000A11000000000000011
11BBBBBBBB000000000000000000000000000A11000000BB0000011
1111111111000000000000000000001111111111000000110000011
1100000000000000000000000000000555555511000000110000011
1100000000000000000000000000000000000011000000110000011
1100000000000000000000000000000000000011000000110000011
1100000000011111111111111111100000000011000000110000011
1100000000000000000000000000000000000011000000110000011
1100000000000000000000000000000000000011000000110000011
1100000000000000000000000000000000000011000000110000011
1111111111111111111111110000000111111111000000110000011
1100000000000000000000000000000000000000000000110000011
1100000000000000000000000000000000000000000000110000011
1100000000000000000000000000000000000000000000110000011
1600000A11000000000000000000000110000011111111110000011
1600000A11000000000000000000000110000011555555110000011
1600000A11444444404444444044444110000011000000110000011
1600000A11111111111111111111111110000011000000110000011
1100000000000000000000000000000000000011000000110000011
1100000000000000000000000000000000000011000000110000011
1100000000000000000000000000000000000011000000110000011
1100000111111111111111111111111111111111000000110000011
1100000111111111111111111111111111111111000000000000011
1100000115555555555555555555555555000000000000000000011
1100000110000000000000000000000000000000000000000000011
1100000000000000000000000000000000000000BBBBBBBB0000011
1100000000000000000000000000000000000000111111110000011
1100000000000000000000000000000000000000111111110000011
1111111111111111111111111111111111000000000000000000011
1111111111111111111111111111111111000000000000000000011
1100000000000000000000000000000000000000000000000000011
1100000000000000000000000000000000000000000000000000011
1100300000000000000000000000000000444444444444440000011
1166666666666666666666666666666666111111111111111111111
1111111111111111111111111111111111111111111111111111111