0
0
0
1
000000000000000000000000000000000000000000000000000
011111111111111111111111111111111111111111111111111
011111111111111111111111111111111111111111111111111
011000000000000000000000000000000000000000000000011
011000000000000000000000000000000000000000000000011
011000000000000000000000000000000000000000000000011
011000000000000000000000000000000000000000000000011
011000000000000000000000000000000000000000000000011
011000000000000000000000000000000000000000000000011
011000000000000000000000000000000000000000000000011
011000000000000000000000000000000000000000000000011
011000000000000000000000000000000000000000000000011
011000000000000000000000000000000000000000000000011
011000000000000000000000000000000000000000000000011
011000000000000000000000000000000000000000000000011
011000000000000000000000000000000000000000000000011
011000000000000000000000000000000000000000000000011
011000000000000000000000000000000000000000000000011
011000000000000000000000000000000000000000000000011
011000000000000000000000000000000000000000000000011
011000000000000000000000000000000000000000000000011
011000000000000000000000000000000000000000000000011
011000000000000000000000000000000000000000000000011
011000000000000000000000000000000000000000000000011
011000000000000000000000000000000000000000000000011
011000000000000000000000000000000000000000000200011
011000300000000000000000000000000000000000000000011
011111111111111111111111111111111111111111111111111
011111111111111111111111111111111111111111111111111