1
1
0
0
1
111111111111111100000000000000000000000000000000000000000000000000000000000000
190000000000000100000000000000000000000000000000000000000000000000000000000000
100000000000000100000000000000000000000000000000000000000000000000000000000000
100000000000000100000000000000000000000000000000000000000000000000000000000000
100000030000000100000000000000000000000000000000000000000000000000000000000000
111111111000000100000000000000000000000000000000000000000000000000000000000000
100000000000000100000000000000000000000000000000000000000000000000000000000000
100000000000000100000000000000000000000000000000000000000000000000000000000000
100000000000000100000000000000000000000000000000000000000000000000000000000000
100000000000000100000000000000000000000000000000000000000000000000000000000000
100000000000000100000000000000000000000000000000000000000000000000000000000000
100000000000000100000000000000000000000000000000000000000000000000000000000000
100000000000000100000000000000000000000000000000000000000000000000000000000000
100000000000000100000000000000000000000000000000000000000000000000000000000000
100000000000000100000000000000000000000000000000000000000000000000000000000000
100000000000000100000000000000000000000000000000000000000000000000000000000000
100000000000000100000000000000000000000000000000000000000000000000000000000000
100000000000000100000000000000000000000000000000000000000000000000000000000000
100000000000000100000000000000000000000000000000000000000000000000000000000000
100000000000000100000000000000000000000000000000000000000000000000000000000000
100000000000000100000000000000000000000000000000000000000000000000000000000000
100000000000000100000000000000000000000000000000000000000000000000000000000000
100000000000000100000000000000000000000000000000000000000000000000000000000000
100000000000000100000000000000000000000000000000000000000000000000000000000000
100000000000000100000000000000000000000000000000000000000000000000000000000000
100000000000000111111111111111111111111111111111111111111111111111111111111111
100000000000000000000000000000000000000000000000000000000000000000000000000001
10000000000000000000000000b000000000000000000000000000b00000000000000000000001
100000000000000000000000000000000000000000000000000000000000000000000000000001
100000000000000000000000000000000000000000000000000000000000000000000000000001
100000000000000000000000000000000000000000000000000000000000000000000000000001
1BBBBBBB0000000444444444444444444444444444044444444444444444444444444440000001
111111111111111111111111111111111111111111111111111111111111111111111111100001
1D0000000000000000000000000000000000000000000000000000000000000000000000100001
1D0000000000000000000000000000000000000000000000000000000000000000000000100001
100000000000000000000000000000000000000000000000000000000000000000000000100001
100000000000000000000000000000000000000000000000000000000000000000000000000001
100000000004444444444444440000000000000000000000000000000000000000000000000001
100000000006666666666666660000000011111111111111111111000000000000000000000001
100000100000000000000000011100000000000000000000000001110000000000000000000001
100000100000000000000000011111100000000000000000000001111110000000000000100001
100000100000000000000000000011111100000000000000000001000111110000000000100001
100000100000000000000000000000011111100000000000000001000000111110000000100001
100000100000000000000000000000000000000000000000000001000000000111110000100001
100000100000000000000000000000000000000000000000000001000000000000000000100001
1000001000000000000000000000000000000000000000000000910000000000000000001BBBB1
100000111111111111111111111111111111111111111111111111111111111111111111111111
100000555555555555555555555555555555555555551000000000000000000000000000000000
100000000000000000000000000000000000000000001000000000000000000000000000000000
100000000000000000000000000000000000000000001000000000000000000000000000000000
100000000000000000000000000000000000000000001000000000000000000000000000000000
100000000000000000000000000000000000000000001000000000000000000000000000000000
100000000000000000000000000000000000000000001000000000000000000000000000000000
100000000BB00000000BB00000000BB00000000000001000000000000000000000000000000000
111111111111111111111111111111111111000000001000000000000000000000000000000000
655555555565555555555555555555555556000000006000000000000000000000000000000000
600000002060000000006000000000000006000000006000000000000000000000000000000000
600000000060000000006000000000000006000000006000000000000000000000000000000000
600000000060000000006000000000660006000000006000000000000000000000000000000000
600000000060000000006000000000660006000000006000000000000000000000000000000000
600000000060000000006000000006660006000000006000000000000000000000000000000000
600000000060000000006000000006660006000000006000000000000000000000000000000000
600000000060000000006000000006600006000000006000000000000000000000000000000000
600006666660000060000000000006600000000000006000000000000000000000000000000000
600000000000000060000000060000000000000000006000000000000000000000000000000000
600000000000000060000000060000000000000666666000000000000000000000000000000000
600000000000000060000000060000000000000600006000000000000000000000000000000000
600000000000000060000000060000000000000600006000000000000000000000000000000000
600000000000000060000000060000000000000600006000000000000000000000000000000000
60000000000000BB60000000060000000000000600006000000000000000000000000000000000
666666666666666666666666666666666666666666666000000000000000000000000000000000