1
0
0
1
00000000000000000000000000000000000
00000000000000000000000000000000000
00000000000000000000000000000000000
00000000000000000000000111111111111
00000000000000000000000111111111111
00000000000000000000000110000000011
00000000000000000000000110000002011
00000000000000000000000110000000011
00000000000000000000000110000011111
00000000000000000000000110000000011
00000000000000000000000110000000011
00000000000000000000000110000000011
00000000000000000000000110000000011
00000000000000000000000110000000011
00000000000000000000000110000000011
00000000000000000000000110000000011
00000000000011111111111110000000011
00000000000011111111111110000000011
00000000000011000000000000000000011
00000000000011000000000000000000011
00000000000011000000000000000000011
00000000000011000000000000000000011
00000000000011000000000000000000011
00000000000011000000000000000000011
00000000000011000300000000000000011
00000000000011111111111111111111111
00000000000011111111111111111111111