1111111111111111111111111111111111111111111111111
1100000000000000000000000000001000000000000000011
1100000000000000000000000000201000000000000000011
1100000000000000000000000000001000000000000000011
1100000000011111111111111111111000000000000000011
1100000000000000000000000000000000000000000000011
1100000000000000000000000000044444444444444444411
1111100000000000000000000000011111111111111111111
1100000000000000000000000000000000000000000000011
1100000000000000000000000000000000000000000000011
1100000000000000000000000000000000000000444440011
1111111111111111111111000000000000000000111111111
1100000000000000000000000000000000000000000000011
1100000000000000000000000000000000000000000000011
1100000000000000000000000000000000000000000000011
1100000000000000000000000000011111111111111111111
1100000000000000000000000000000000000000000000011
1100000000000000000000000000000000000000000000011
1100000000044444444444444444444000000000000000011
1100000000011111111111111111111000000000000000011
1100000000000000000000000000000000000000000000011
1100000000000000000000000000000000000000000000011
1100000000000000000000000000000000000000000000011
1100000000000000000000000000011111111111111111111
1100000000000000000000000000000000000000000000011
1100000000000000000000003000000000000000000000011
1144444444444444444444444444444444444444444444411
1111111111111111111111111111111111111111111111111