1
1
1
0
111111111111111111111111111111111111111111111111111111111111111111111111111111111111111111111111111111111111111111111111111111111
111111111111111111111111111111111111111111111111111111111111111111111111111111111111111111111111111111111111111111111111111111111
110000000000000000000000000000000000000000000000000000000000000000000000C00000C0000000000C000000000000C00000000000000000000000A11
110000000000000000000000000000000000000000000000000000000000000000000000000000000000000000000000000000000000000000000000000000A11
110000000000000000000000000000000000000000000000000000000000000000000000000000000000000000000000000000000000000000000000000000A11
110200000000000000000000000000000000000000000000000000006666666000000000000000000000000000000000000000000000000000000000000000A11
110000000000000000000000000000000000000000000000000000000000000000000000000000000000006666666000000000000000000000000000000000A11
111110000000000000000000000000000000000000000000000000000000000000000666666600000000000000000000000000000000000000000000000000A11
110000000000000000000000000000000000000000000000000000000000000000000000000600000000000000000000000666666600000000000000000000A11
1100000000EEEEEEEEEEEEEEEE0000000000000000066666660000000000000000000000000666666600000000000000000000000000000000000000000000011
110000000000000000000000000000000000000000044444444444444444444444444444444444444444444444444444444444444444444400000000000000011
111111111111111111111111111111111111111111111111111111111111111111111111111111111111111111111111111111111111111100000000000000011
110000000000000000000000000000000000000000000000000000000000000000000000000000000000000000000000000000000000001100111100000000011
110004444444000000000000000000000000000000000000000000000000000000000000000000000000000000000000000000000000001100000000000000011
110001111111000001111100000000000000000000000000000000000000000000000000000000000000000000000000000000000000001100000000000000011
110000000000000000000111110000000001111111111111100000000000000000000000000000000000000000000000000000000000001100000000011110011
110000000000000000000000000000000000000000000001100000000000000000000000000000000111111111100000000000000000001100000000000000011
1100000000000000000000000000000000000000000000011000011111111110000000000000000000000000000000000000000000000011D0000000000000011
110000100000000000000000000000000000000000100001100000000000000000000000000000000000000000000000000000000000001100111100000000011
110000100000001111111111111111111111000000100001100000000000000000011111111110000000000000000000000000000000001100000000000000011
110000100000000000000000000000000000000000100001100000000000000000000000000000000000000000000001111111111000001100000000000000011
110000111111000000000000000000000000011111100001100000000000000000000000000000000000000000000000000000000000000000000000011110011
110000555555000000000003000000000000055555500001100000000000000000000000000000000000000000000000000000000000000000000000000000011
1100000000000000000000000000000000000000000000A11BBBBBBBBBBBBBBBBBBBBBBBBBBBBBBBBBBBBBBBBBBBBBBBBBBBBBBBB000000000000000000000011
111111111111111111111111111111111111111111111111111111111111111111111111111111111111111111111111111111111111111111111111111111111
111111111111111111111111111111111111111111111111111111111111111111111111111111111111111111111111111111111111111111111111111111111