1
1
0000000000000000000000000000000111111111111111111
0000000000000000000000000000000144444444444444411
0000000000000000000000000000000100000000000000011
0000000000000000000000000000000100000020000000011
0000000000000000000000000000000100000000000000011
1111111111111111111111111111111100000111111111111
1100000000000000000014444444444400000001111000011
1100000000000000000010000000000000000001111000011
1100000000000000000010000000000000000000001000011
1100000000010000000010000000000000000000001000011
1100000000010000000010000000000000000000001000011
1100000000010000000010000000000000000000001000011
1100000000010000000000000000000000000000001000011
1100000000010000000000000000000000011111111000011
1100000000010000100000001000000000000000000000011
1100000000010000100000001000000000000000000000011
1100000000010000100000001000000000000000000000011
1100000000010000100000001000001111111000000000011
1100000000010000100000001000000000000000000000011
1100000000010000100000001000000000000000000000011
1144444400000000100000001444444444444444444444411
1111111100000001111111111111111111111111111111111
1111111100000005555555555555500000000000000000011
1111111100000000000000000000000000000000000000011
1111110000000000000000000000000000001111111000011
1111110000000000000000000000000000000000000000011
1111000000000000000000000000044444444444444444411
1111000000000000000000000000011111111111111111111
1100000000000000000000000000000000000000000000011
1100000000000000000000000000000000000000000000011
1100000000000000000000000000000000000000444444411
1111111111111111111100000000000000000000111111111
1155555555555555555500000000000000000000000000011
1100000000000000000000000000000000000000000000011
1100000000000000000000000000000000000000000000011
1100000000000000000000000000011111111111111111111
1100000000000000000000000000000000000000000000011
1100000000000000000000000000000000000000000000011
1100000000044444444444444444444000000000000000011
1100000000011111111111111111111000000000000000011
1100000000000000000000000000000000000000000000011
1100000000000000000000000000000000000000000000011
1100000000000000000000000000000000000000000000011
1100000000000000000000000000011111111111111111111
1100000000000000000000003000000000000000000000011
1144444444444444444444444444444444444444444444411
1111111111111111111111111111111111111111111111111
1111111111111111111111111111111111111111111111111