1111111111111111111111111111111111111111111111111
1100000000000000000000000000000000000000000000011
1100000000000000000000000000010000000000000000011
1100000000000000000000000000010000000000000100011
1100000000000000000000000000010000000000000100011
1100000000000000000000000100000000000000000100011
1100000000000000000000000100000000000000000102011
1100000000000000000000000111111111110000000111111
1100000000000000000000000000000000000000000000011
1100000000000000000000000000000000000000000000011
1100000000000000111111111110000000000000000000011
1100000001111000000000000000000000000000000000011
1100000000001000000000000000000000000000000000011
1100000000001000000000000111111111110000000111111
1144444000001000000000000000000000000000000000011
1111111000000000000000000000000000000000000000011
1100001000000000000000000000000000000000000000011
1100001000000000000000000111111111110000000111111
1100001000000000000000000000000000000000000000011
1100000000000000000000000000000000000000000000011
1100000000000000000000000000000000000000000000011
1100000000011111000111110000000000000000000000011
1100000000011111000111110000000000000000000000011
1100000000011111000111110000000000000000000000311
1100000000011111000111110000000000000000000001111
1100000000011111444111114444444444444444444444411
1111111111111111111111111111111111111111111111111
1111111111111111111111111111111111111111111111111