1
1
1
0
11111111111111111111111111111111111111111111111111111111111111111111111111111111111111111111111111111111111111111111111111111111111
10000000000000000000000000000000000000000000000000000000000000000000000C00000C0000000000C000000000000C000000000000000000000000000A1
100000000000000000000000000000000000000000000b00000000000000000000000000000000000000000000000000000000000000000000000000000000000A1
100000000000000000000000000000000000000000000000000000000000000000000000000000000000000000000000000000000000000000000000000000000A1
102000000000000000000000000000000000000000000000000000066666660000000000000000000000000000000000000000000000000000000000000000000A1
100000000000000000000000000000000000000000000000000000000000000000000000000000000000066666660000000000000000000000000000000000000A1
111100000000000000000000000000000000000000000000000000000000000000006666666000000000000000000000000000000000000000000000000000000A1
100000000000000000000000000000000000000000000000000000000000000000000000006000000000000000000000006666666000000000000000000000000A1
100000000EEEEEEEEEEEEEEEE0000000000000000066666660000000000000000000000000666666600000000000000000000000000000000000000000000000001
10000000000000000000000000000000000000000044444444444444444444444444444444044444444444444444444444444444444444000000000000000000001
11111111111111111111111111111111111111111111111111111111111111111111111111111111111111111111111111111111111111111111110000000000001
10000000000000000000000000000000000000000000000000000000000000000000000000000000000000000000000000000000000001100000000000000000001
10000000000000000000000000000000000000000000000000000b00000000000000000000000000000000000000000000000000000001100000000000000000001
10000000000000000000000000000000000000000000000000000000000000000000000000000000000000000000000000000000000001100000000001111110001
10004444444000000000000000000000000000000000000000000000000000000000000000000000000000000000000000000000000001100000000000000000001
10001111111000001111100000000000000000000000000000000000000000000000000000000000000000000000000000000000000001100000000000000000001
100000000000000000001111100000000011111111111111000000000000000000000000000000000000000000000000000000000000011D0000000000000000001
10000000000000000000000000000000000000000000001100000000000000000000000000000000111111111100000000000000000001100011111100000000001
10000000000000000000000000000000000000000000001100001111111111000000000000000000000000000000000000000000000001100000000000000000001
10000100000000000000000000000000000000000100001100000000000000000000000000000000000000000000000000000000000001100000000000000000001
10000100000000011111111111111111100000000100001100000000000000000011111111110000000000000000000000000000000001100000000000000000001
10000190000000000000000000000000000000000100001100000000000000000000000000000000000000000000001111111111000001100000000001111110001
10000111111000000000000000000000000011111100001100000000000000000000000000000000000000000000000000000000000000000000000000000000001
10000555555000000000003000000000000055555500001100000000000000000000000000000000000000000000000000000000000000000000000000000000001
100000000000000000000000000000000000000000000A11BBBBBBBBBBBBBBBBBBBBBBBBBBBBBBBBBBBBBBBBBBBBBBBBBBBBBBBBB00000000000000000000000001
11111111111111111111111111111111111111111111111111111111111111111111111111111111111111111111111111111111111111111111111111111111111