1
1
1111111111111111111111111111111111111111111111111
1111110000000000000011110000000000000000000000011
1111100000000000000001110004444444440000000000011
1111000000100000000000000001111111110000000000011
1110000000100000000000000000000000010000000000011
1100000000100000000000000000000002010000000000011
1100000000100000000000000100000000010000000444411
1100000000100000000000000111111111110000000111111
1100000000100000000000000000000000000000000000011
1100000000144444444444444444444444444444444444411
1100000000111111111111111111111111111111111111111
1100000000000000110000000000000000000000000000011
1100000000000000110000000000000000000000000000011
1100000011100000000000000000000000004444444000011
1100000000100000000000111111100000001111111000011
1100000000100000000000111111100000001111111000011
1144444000100000000000555555500000000000000000011
1111111000000000000000000000000000000000000000011
1100001000000000000000000000000000000000000000011
1100001000000000000000000000011111110000000111111
1100001000000000000000000000011111114444444111111
1100000000011111111111111111111111111111111111111
1100000000000000000000000000000000000000000000011
1100000000000000000000000000000000000000000000011
1100000000000000000000000000000000000000000000011
1100000000011111000111110000000000000000000000011
1100000000011111000111110000000000000000000000011
1100000000011111000111110000000000000000000000311
1100000000011111000111110000000000000000000001111
1100000000011111444111114444444444444444444444411
1111111111111111111111111111111111111111111111111
1111111111111111111111111111111111111111111111111