1
1
0
0
11111111111111111100000000000000000000000000000000000000000000000000000000000000
11900000000000001100000000000000000000000000000000000000000000000000000000000000
11000000000000001100000000000000000000000000000000000000000000000000000000000000
11000000000000001100000000000000000000000000000000000000000000000000000000000000
11000000300000001100000000000000000000000000000000000000000000000000000000000000
11111111110000001100000000000000000000000000000000000000000000000000000000000000
11000000000000001100000000000000000000000000000000000000000000000000000000000000
11000000000000001100000000000000000000000000000000000000000000000000000000000000
11000000000000001100000000000000000000000000000000000000000000000000000000000000
11000000000000001100000000000000000000000000000000000000000000000000000000000000
11000000000000001100000000000000000000000000000000000000000000000000000000000000
11000000000000001100000000000000000000000000000000000000000000000000000000000000
11000000000000001100000000000000000000000000000000000000000000000000000000000000
11000000000000001100000000000000000000000000000000000000000000000000000000000000
11000000000000001100000000000000000000000000000000000000000000000000000000000000
11000000000000001100000000000000000000000000000000000000000000000000000000000000
11000000000000001100000000000000000000000000000000000000000000000000000000000000
11000000000000001100000000000000000000000000000000000000000000000000000000000000
11000000000000001100000000000000000000000000000000000000000000000000000000000000
11000000000000001100000000000000000000000000000000000000000000000000000000000000
11000000000000001100000000000000000000000000000000000000000000000000000000000000
11000000000000001100000000000000000000000000000000000000000000000000000000000000
11000000000000001100000000000000000000000000000000000000000000000000000000000000
11000000000000001100000000000000000000000000000000000000000000000000000000000000
11000000000000001100000000000000000000000000000000000000000000000000000000000000
11000000000000001111111111111111111111111111111111111111111111111111111111111111
11000000000000000000000000CC0000000000CC0000000000CC0000000000CC0000000000000011
11000000000000000000000000000000000000000000000000000000000000000000000000000011
11000000000000000000000000000000000000000000000000000000000000000000000000000011
11000000000000000000000000000000000000000000000000000000000000000000000000000011
11000000000000000000000000000000000000000000000000000000000000000000000000000011
11BBBBBBB00000004444444444444444444444444444444444444444444444444444444400000011
11111111111111111111111111111111111111111111111111111111111111111111111111000011
11D00000000000000000000000000000000000000000000000000000000000000000000001000011
11D00000000000000000000000000000000000000000000000000000000000000000000001000011
11D00000000000000000000000000000000000000000000000000000000000000000000001000011
11000000000000000000000000000000000000000000000000000000000000000000000000000011
11000000000044444444444444444000000000000000000000000000000000000000000000000011
11000000000066666666666666666000000011111111111111111100000000000000000000000011
11000001000000000000000000111000000000000000000000000011100000000000000000000011
11000001000000000000000000111111000000000000000000000011111100000000000001000011
1100000100000000000000000000011111100000000000000000001D001111100000000001000011
1100000100000000000000000000000011111100000000000000001D000001111100000001000011
1100000100000000000000000000000000000000000000000000001D000000001111100001000011
1100000100000000000000000000000000000000000000000000001D000000000000000001000011
1100000100000000000000000000000000000000000000000000091D000000000000000001BBBB11
11000001111111111111111111111111111111111111111111111111111111111111111111111111
11000005555555555555555555555555555555555555511000000000000000000000000000000000
11000000000000000000000000000000000000000000011000000000000000000000000000000000
11000000000000000000000000000000000000000000011000000000000000000000000000000000
11000000000000000000000000000000000000000000011000000000000000000000000000000000
11000000000000000000000000000000000000000000011000000000000000000000000000000000
11000000000000000000000000000000000000000000011000000000000000000000000000000000
1100000000BB00000000BB00000000BB000000000000011000000000000000000000000000000000
11111111111111111111111111111111111110000000011000000000000000000000000000000000
66555555555655555555555555555555555560000000066000000000000000000000000000000000
66900000020600000000060000000000000060000000066000000000000000000000000000000000
66000000000600000000060000000000000060000000066000000000000000000000000000000000
66000000000600000000060000000006600060000000066000000000000000000000000000000000
66000000000600000000060000000006600060000000066000000000000000000000000000000000
66000000000600000000060000000066600060000000066000000000000000000000000000000000
66000000000600000000060000000066600060000000066000000000000000000000000000000000
66000000000600000000060000000066000060000000066000000000000000000000000000000000
66000066666600000600000000000066000000000000066000000000000000000000000000000000
66000000000000000600000000600000000000000000066000000000000000000000000000000000
66000000000000000600000000600000000000006666666000000000000000000000000000000000
66000000000000000600000000600000000000006000066000000000000000000000000000000000
66000000000000000600000000600000000000006000066000000000000000000000000000000000
66000000000000000600000000600000000000006000066000000000000000000000000000000000
660000000000000BB600000000600000000000006000066000000000000000000000000000000000
66666666666666666666666666666666666666666666666000000000000000000000000000000000