1
1
000000000000000000000000000000000000000000000000000
011111111111111111111111111111111111111111111111111
011111111111111111111111111111111111111111111111111
011000000000000000000000000000000000000000000000011
011000000000000000000000000000000000000000000009011
011000000000000000000000000000000000000000000000011
011111000000111111100001111111111111111100001111111
011000000000100000000000000000001555555100000000011
011000000000100000000000000000001000000100000000011
011000066666100000000000000000001000000100000000011
011000066666111111111111100000001000000111111000011
011000000000100000000000000000001000000000000000011
011000000000102000000000000000001000000000000000011
011666600000100000000000000008881000000000000000011
011666600000111111111111111111111000000111111111111
011000000000000000000001000000000000000100000000011
011000000000000000000001000000000000000100000000011
011000066666600000000001000011111110000100000000011
011000066666600000000001000011111110000000000000011
011000000000000000000000000011111110000000000000011
011000000000000000000000000011111110000000000000011
011111111111111111111111000000000000000111111000011
011000000000000000000000000000000000000000071000011
011000000000000000000000000000000000000000071000011
011000000000000000000000000000000000000000071000011
011000000000001111111111111111111111111111111000011
011000000000000000000000000000000000000000000000011
011000000000000000000000000000000000000000000000011
011000000000000000000000000000000000000000000000011
011000011111111111111111111111100000000000000009011
011000000000000000000000000001188800000000000000011
011000000000000000000000000001111111111111111111111
011666000000000000000000000001111111111111111111111
011666000000000000000000000000000000000000000000011
011666000000000000000000030000000000000000000000011
011111111111111111111111111111111111111111111111111
011111111111111111111111111111111111111111111111111