1
0
0
0
000000000000000000000000000000000000
000000000000000000000000000000000000
000000000000111111111111111111111111
000000000000111111111111111111111111
000000000000110000000001000000100011
000000000000110000000201000000100011
000000000000110000000001000000100011
000000000000110000000000000000000011
000000000000110000000000000000000011
0000000000001100000000000001D0000011
0000000000001100000000000001D0000011
0000000000001111111111111111D0000011
00000000000011CCCCCCCCCCCCCC00000011
000000000000110000000000000000000011
000000000000110000000000000000000011
000000000000110000000000000000000011
000000000000110000000000000000000011
000000000000110000000000000000000011
000000000000110000000000000000000011
000000000000110000000000000000000011
000000000000110000000000000000000011
000000000000110000000003000000000011
000000000000110000000000000000000011
000000000000114444444444444444444411
000000000000111111111111111111111111
000000000000111111111111111111111111
