1
1
0
0
1111111111111111111111111111111111111111111111111
1100000000000000000000000000000000000000000000011
1100000000000000000000000000000000000000000000011
1100000000000000000000000000000000000000000000011
1100000000000000000000000004444444440000000000011
1100000000111111111000000001111111110000000000011
1100000000100000009000000000000000010000000000011
1100000000100000000000000000000002010000000000011
1100000000100000000000000000000000010000000BBBB11
1100000000100000000000000111111111110000000111111
1100000000100000000000000000000000000000000000011
1100000000100000000000000000000000000000000000011
1100000000144444444444444444444444444444440000011
1100000000111111111111111111111111111111111000011
1100000000000000000000000000000000000000000000011
1100000000000000000000000000000000000000000000011
110000001110000000000000000000000000BBBBBBB000011
1100000000100000000000666666600000001111111000011
1100000000100000000000555555500000000000000000011
1144444000100000000000000000000000000000000000011
1111111000000000000000000000000000000000000000011
1100001000000000000000000000066666660000000111111
1100001000000000111111111111111111111111111111111
1100000000000000000000000000000000000000000000011
1100000000000000000000000000000000000000000000011
1100000000000000000000000000000000000000000000011
1100000000000000000000000000000000000000000000011
11000000A1111110000000000000000000000000000000011
11000000A1100000000000000000000000000000000300A11
11000000A1100000006666660000000000000000000111111
11000000A1144444446644444444444444444444444444411
1111111111111111111111111111111111111111111111111
1111111111111111111111111111111111111111111111111
