1
0
000000000000000000000000000000000000
000000000000000000000000000000000000
000000000000111111111111111111111111
000000000000111111111111111111111111
000000000000110000000000110000000011
000000000000110000000020110000000011
000000000000110000000000110000000011
000000000000110000000000000000000011
000000000000110000000000000000000011
000000000000110000000000000001100011
000000000000110000000000000001100011
000000000000110000000000000001100011
000000000000110000000000000001100011
000000000000110000000000000001100011
000000000000110000000000000001100011
000000000000110000000000000000000011
000000000000110000000000000000000011
000000000000110000000000000000000011
000000000000114444444440000000000011
000000000000111111111111110000000011
000000000000111111111111110000000011
000000000000110000000000000000000011
000000000000110000000000000000000011
000000000000110000000003000000000011
000000000000111111111111111111111111
000000000000111111111111111111111111