0
0
000000000000000000000000000000000000000000000000000
011111111111111111111111111111111111111111111111111
011111111111111111111111111111111111111111111111111
011000000000000000000000000000000000000000000000011
011000000000000000000000000000000000000000000000011
011000000000000000000000000000000000000000000000011
011000000000000000000000000000000000000000000000011
011000000000000000000000000000000000000000000000011
011000000000000000000000000000000000000000000000011
011000000000000000000000000000000000000000000000011
011000000000000000000000000000000000000000000000011
011000000000000000000000000000000000000000000000011
011000000000000000000000000000000000000000000000011
011000000000000000000000000000000000000000000000011
011000000000000000000000000000000000000000000000011
011000000000000000000000000000000000000000000000011
011000000000000000000000000000000000000000000000011
011000000000000000000000000000000000000000000000011
011000000000000000000000000000000000000000000000011
011000000000000000000000000000000000000000000020011
011003000000000000000000000000000000000000000000011
011111111111111100000000000111111111111111111111111
011111111111111100000000000111111111111111111111111
000000000000001100000000000110000000000000000000000
000000000000001111110000000110000000000000000000000
000000000000001111110000000110000000000000000000000
000000000000000000110000000110000000000000000000000
000000000000000000111111111110000000000000000000000
000000000000000000111111111110000000000000000000000