1
1
1
0
111111111111111111111111111111111111111111111111111111111111111111111111111111111111111111111111111111111111111111111111111111111
10000000000000000000000000000000000000000000000000000000000000000000000C00000C0000000000C000000000000C0000000000000000000000000A1
100000000000000000000000000000000000000000000b000000000000000000000000000000000000000000000000000000000000000000000000000000000A1
1000000000000000000000000000000000000000000000000000000000000000000000000000000000000000000000000000000000000000000000000000000A1
1020000000000000000000000000000000000000000000000000000666666600000000000000000000000000000000000000000000000000000000000000000A1
1000000000000000000000000000000000000000000000000000000000000000000000000000000000000666666600000000000000000000000000000000000A1
1111000000000000000000000000000000000000000000000000000000000000000066666660000000000000000000000000000000000000000000000000000A1
1000000000000000000000000000000000000000000000000000000000000000000000000060000000000000000000000066666660000000000000000000000A1
100000000EEEEEEEEEEEEEEEE00000000000000000666666600000000000000000000000006666666000000000000000000000000000000000000000000000001
100000000000000000000000000000000000000000444444444444444444444444444444440444444444444444444444444444444444444000000000000000001
111111111111111111111111111111111111111111111111111111111111111111111111111111111111111111111111111111111111111000000000011110001
190000000000000000000000000000000000000000000000000000000000000000000000000000000000000000000000000000000000011000000000000000001
10000000000000000000000000000000000000000000000000000b000000000000000000000000000000000000000000000000000000011000000000000000001
100000000000000000000000000000000000000000000000000000000000000000000000000000000000000000000000000000000000011000111100000000001
100044444440000000000000000000000000000000000000000000000000000000000000000000000000000000000000000000000000011000000000000000001
100011111110000011111000000000000000000000000000000000000000000000000000000000000000000000000000000000000000011000000000000000001
100000000000000000001111100000000011111111111111000000000000000000000000000000000000000000000000000000000000011000000000011110001
100000000000000000000000000000000000000000000011000000000000000000000000000000001111111111000000000000000000011000000000000000001
100000000000000000000000000000000000000000000011000011111111110000000000000000000000000000000000000000000000011D00000000000000001
100001000000000000000000000000000000000001000011000000000000000000000000000000000000000000000000000000000000011000111100000000001
100001000000001111111111111111111100000001000011000000000000000000111111111100000000000000000000000000000000011000000000000000001
100001000000000000000000000000000000000001000011000000000000000000000000000000000000000000000011111111110000011000000000000000001
100001111110000000000000000000000000111111000011000000000000000000000000000000000000000000000000000000000000000000000000011110001
100005555550000000000030000000000000555555000011000000000000000000000000000000000000000000000000000000000000000000000000000000001
100000000000000000000000000000000000000000000A11BBBBBBBBBBBBBBBBBBBBBBBBBBBBBBBBBBBBBBBBBBBBBBBBBBBBBBBB0000000000000000000000001
111111111111111111111111111111111111111111111111111111111111111111111111111111111111111111111111111111111111111111111111111111111