1
1
1
0
11111111111111111111111111111111111111111111111111111111111111111111111111111111111111111111111111111111111111111111111111111111111
11111111111111111111111111111111111111111111111111111111111111111111111111111111111111111111111111111111111111111111111111111111111
110000000000000000000000000000000000000000000000000000000000000000000000C00000C0000000000C000000000000C0000000000000000000000000A11
11000000000000000000000000000000000000000000000000000000000000000000000000000000000000000000000000000000000000000000000000000000A11
11000000000000000000000000000000000000000000000000000000000000000000000000000000000000000000000000000000000000000000000000000000A11
11020000000000000000000000000000000000000000000000000000666666600000000000000000000000000000000000000000000000000000000000000000A11
11000000000000000000000000000000000000000000000000000000000000000000000000000000000000666666600000000000000000000000000000000000A11
11111000000000000000000000000000000000000000000000000000000000000000066666660000000000000000000000000000000000000000000000000000A11
11000000000000000000000000000000000000000000000000000000000000000000000000060000000000000000000000066666660000000000000000000000A11
1100000000EEEEEEEEEEEEEEEE000000000000000006666666000000000000000000000000066666660000000000000000000000000000000000000000000000011
11000000000000000000000000000000000000000004444444444444444444444444444444404444444444444444444444444444444444440000000000000000011
11111111111111111111111111111111111111111111111111111111111111111111111111111111111111111111111111111111111111110000000000111100011
11900000000000000000000000000000000000000000000000000000000000000000000000000000000000000000000000000000000000110000000000000000011
11000000000000000000000000000000000000000000000000000000000000000000000000000000000000000000000000000000000000110000000000000000011
11000000000000000000000000000000000000000000000000000000000000000000000000000000000000000000000000000000000000110001111000000000011
11000444444400000000000000000000000000000000000000000000000000000000000000000000000000000000000000000000000000110000000000000000011
11000111111100000111110000000000000000000000000000000000000000000000000000000000000000000000000000000000000000110000000000000000011
11000000000000000000011111000000000111111111111110000000000000000000000000000000000000000000000000000000000000110000000000111100011
11000000000000000000000000000000000000000000000110000000000000000000000000000000011111111110000000000000000000110000000000000000011
1100000000000000000000000000000000000000000000011000011111111110000000000000000000000000000000000000000000000011D000000000000000011
11000010000000000000000000000000000000000010000110000000000000000000000000000000000000000000000000000000000000110001111000000000011
11000010000000011111111111111111111000000010000110000000000000000001111111111000000000000000000000000000000000110000000000000000011
11000010000000000000000000000000000000000010000110000000000000000000000000000000000000000000000111111111100000110000000000000000011
11000011111100000000000000000000000001111110000110000000000000000000000000000000000000000000000000000000000000000000000000111100011
11000055555500000000000300000000000005555550000110000000000000000000000000000000000000000000000000000000000000000000000000000000011
1100000000000000000000000000000000000000000000A11BBBBBBBBBBBBBBBBBBBBBBBBBBBBBBBBBBBBBBBBBBBBBBBBBBBBBBBB00000000000000000000000011
11111111111111111111111111111111111111111111111111111111111111111111111111111111111111111111111111111111111111111111111111111111111
11111111111111111111111111111111111111111111111111111111111111111111111111111111111111111111111111111111111111111111111111111111111