1
1
0000000000000000000000000000000111111111111111111
0000000000000000000000000000000155555555555555511
0000000000000000000000000000000100000000000000011
0000000000000000000000000000000100000000000020011
0000000000000000000000000000000100000000000000011
1111111111111111111111111111111100000611111111111
1160001000000000000A15555555555500000611111000011
1160001000000000000A10000000000000000000111000011
1160001000000000000A10000000000000000000111000011
1160001000010000000A10000000000000000000001000011
1160001000010000000010000000000000000000001000011
1160000000010000000010000000000000000000001000011
1160000000010000000000000000000000000000001000011
1160000000010000000000000000000000011111111000011
1160000000010000100000001000000000000000000000011
1160000000010000100000001000000000000000000000011
1160000000010000100000001000006666666000000000011
11600000000100001000000A1000006666666000000000011
11600000000100001000000A1000000000000000000000011
11600000000100001000000A1000000000000000000000011
11644444000000001000000A1444444444444444444444411
1111111600000001111111111111111111111111111111111
1111111600000005555555555555500000000000000000011
1111111600000000000000000000000000000000000000011
1111110000000000000000000000000000001111111000011
1111110000000000000000000000000000000000000000011
1111000000000000000000000000044444444444444444411
1111000000000000000000000000011111111111111111111
1100000000000000000000000000000000000000000000011
1100000000000000000000000000000000000000000000011
1100000000000000000000000000000000000000444444411
1111111111111111111100000000000000000000111111111
1155555555555555555500000000000000000000000000011
1100000000000000000000000000000000000000000000011
1100000000000000000000000000000000000000000000011
1100000000000000000000000000011111111111111111111
1100000000000000000000000000000000000000000000011
1100000000000000000000000000000000000000000000011
1109000000004444444444444444440000000000000000011
1100000000011111111111111111111000000000000000011
1100000000000000000000000000000000000000000000011
1100000000000000000000000000000000000000000000011
1100000000000000000000000000000000000000000000011
1100000000000000000000000000011111111111111111111
1100000000000000000000000000000000000000000000A11
1100000000000000000000003000000000000000000000A11
1144444444444444444444444444444444444444444444411
1111111111111111111111111111111111111111111111111
1111111111111111111111111111111111111111111111111