1
1
0
1111111111111111111111111111111111111111111111111
1111111111111111111111111111111111111111111111111
1100000000000000000000000000000000000000000000A11
1100000000000000000000000000000000000000000000A11
1100000000000000000000000000000000000000000000A11
1102000000000000000000000000000000000000000000A11
1100000000000000000000000000000000000000000000A11
11111000EEEEEEEEEEEEEEEEEE00000000000000000000A11
1100000000000000000000000000000000000000000000A11
1666666666666666666666666666666600000000000000A11
1100000000000000000000000000000000000000000111111
1100000000000000000000000000000000006600000000011
1100000000000000000000000000000000006600000000011
1100044444440000000000000000000000000000000000011
1100011111110000000000001111000000000000000000011
1100000000000000000000000001111000000000000000011
1100000000000000000000000000001111000000000000011
1100000000011110000000000000000000000000000000011
1100000000010000000000000000000000000000000000011
1100000011110001110111000000000000001111100000011
1100000000000000010100000000000000001000000000011
11D0000000000000011100000000000000001000000000011
1111111000000000001000000000000011111000000000A11
1100000000000000001000000000000000000000000000A11
1100000000000000011100000000000000000000000000A11
1100001000000000010100000000000000000000001000011
1100001000000001110111000066666660000000001000011
1100001000000000000000000000000000000000001000011
1100001111110000000000000000000000000111111000011
1100005555550000000000030000000000000555555000011
1111111111111111111111111111111111111111111111111
1111111111111111111111111111111111111111111111111