1
1
1111111111111111111111111111111111111111111111111111111
1111111111111111111111111111111111111111111111111111111
1100000008880000000000000000000000000000000000110000011
1100000001110000000000000000000000000000000000110000011
1100000000000000000000000000000000000000000000110000011
1100000000200000000000000000000000000000000000110000011
1100000000000004444044440444440444404444000000110000011
1100000011111111111111111111111111111111000000110000011
1100000000000000000000000000000000000711000000110000011
1100000000000000000000000000000000000711000000110000061
1100000000000000088888880000000000000711000000000000061
1100000011000000011111110000001111111111000000000000061
1100000011000000011111110000001555555511000000110000061
1100000011000000011111110000001000000011000000110000011
1100000011000000011111110000001000000011000000110000011
1100000011000000011111110000001110000011000000110000011
1100000011000000011111110000000000000011000000110000011
1100000011000000011111110000000000000011000000110000011
1111100011000000011111110000000000000011000000110000011
1100000011000000011111110000001110000011000000110000011
1100000011000000011111110000001000000011000000110000011
1100000011000000011111110000001000000011000000110000011
1100011111000000011111110000001000000011000000110000011
1100000011000000011111110001111000000011000000110000011
1100000011000000000000000000000000000000000000110000011
1144400011000000000000000000000000000000000000110000011
1111100011000000000000000000000110000011111111110000011
1100000011000000000000000000000110000011555555110000011
1100000011444444404444444044444110000011000000110000011
1111111111111111111111111111111110000011000000110000011
1100000000000000000000000000000000000011000000110000011
1100000000000000000000000000000000000011000000110000011
1100000000000000000000000000000000000011000000110000011
1100000111111111111111111111111111111111000000110000011
1100000111111111111111111111111111111111000000000000011
1100000115555555555555555555555555000000000000000000011
1100000110000000000000000000000000000000000000000000011
1100000000000000000000000000000000000000888888880000011
1100000000000000000000000000000000000007111111110000011
1100000000000000000000000000000000000007111111110000011
1111111111111111111111111111111111000000000000000000011
1111111111111111111111111111111111000000000000000000011
1100000000000000000000000000000000000000000000000000011
1100000000000000000000000000000000000000000000000000011
1100300000000000000000444444444444444444444444440000011
1111111111111111111111111111111111166666111111111111111
1111111111111111111111111111111111111111111111111111111