0
0
000000000000000000000000000000000000000000000000000
011111111111111111111111111111111111111111111111111
011111111111111111111111111111111111111111111111111
011000000000000000000000000000000000000000000000011
011000000000000000000000000000000000000000000000011
011000000000000000000800000000000000700000000000011
011000000000000000000000000000000000000000000000011
011000000000000000000000000000000000000000000000011
011000007000000000000000000000000000000000000800011
011000000000000000000000000000000000000000000000011
011000000000000000000000000000000000000000000000011
011000000000000000000000000000000000000000000000011
011000000000000000000000000000000000000000000000011
011000000000000000000000000000000000000000000000011
011000000000000000000000000000000000000000000000011
011000000000000000000000000000000000000000000000011
011000000000000000000000000000000000000000000000011
011000000000000000000000000000000000000000000000011
011000000000000000000000000000000000000000000000011
011000000000000000000000000000000000000000000000011
011000000000000000000000000000000000000000000000011
011000000000000000000000000000000000000000000000011
011000000000000000000000000000000000000000000000011
011000000000000000000000000000000000000000000000011
011000000000000000000000000000000000000000000000011
011000000000000000000000000000000000000000000200011
011000300000000070000000000000000008000000000000011
011111111111111111111111111111111111111111111111111
011111111111111111111111111111111111111111111111111