0
0
1
000000000000000000000000000000000000000000000000000
011111111111111111111111111111111111111111111111111
011111111111111111111111111111111111111111111111111
011000000000000000000000000000000000000000000000011
011000000000000000000000000000000000000000000000011
011000000000000000000000000000000000000000000000011
011000000000000000000000000000000000000000000000011
011000000000000000000000000000000000000000000000011
011000000000000000000000000000000000000000000000011
011000000000000000000000000000000000000000000000011
011000000000000000000000000000000000000000000000011
011000000000000000000000000000000000000000000000011
011000000000000000000000000000000000000000000000011
011000000000000000000000000000000000000000000000011
011000000000000000000000000000000000000000000000011
011000000000000000000000000000000000000000000000011
011000000000000000000000000000000000000000000000011
011000000000000000000000000000000000000000000000011
011000000000000000000000000000000000000000000000011
011000000000000000000000000000000000000000000000011
011000000000000000000000000000000000000000000000011
011000000000000000000000000000000000000000000000011
011000000000000000000000000000000000000000000000011
011000000000000000000000000000000000000000000000011
011000000000000000000000000000000000000000000000011
01100000000000000000000000A111111111000000000200011
01100030000000000000000000A111111111000000000000011
011111111111111666666666611111111111111111111111111
011111111111111111111111111111111111111111111111111